        XXX
        XEX
XXXXX...X X...
    X. .X#X. .
 a  X. .X.X. .
    XC ..&.. .
X#XXX    A   .
 .  X B    C..
 B  X .   c
   .#.&.C  b S
 C..X .   c
    X B    b
XXXXX
