   X     X   
 a #.&B  X E 
   X .   X   
XXXX C   XX#X
 ...A     .. 
 .     A..&  
X#XX  c   A  
   X     XXXX
 a #.A C.# b 
   X  S  X   